****************************
*            **            *
* **** ***** ** ***** **** *
* **** ***** ** ***** **** *
* **** ***** ** ***** **** *
*                          *
* **** ** ******** ** **** *
* **** ** ******** ** **** *
*      **    **    **      *
****** ***** ** ***** ******
****** ***** ** ***** ******
****** **          ** ******
****** ** **    ** ** ******
****** ** *      * ** ******
          *      *          
****** ** *      * ** ******
****** ** **    ** ** ******
****** **          ** ******
****** ** ******** ** ******
****** ** ******** ** ******
*            **            *
* **** ***** ** ***** **** *
* **** ***** ** ***** **** *
*   **                **   *
*** ** ** ******** ** ** ***
*** ** ** ******** ** ** ***
*      **    **    **      *
* ********** ** ********** *
* ********** ** ********** *
*                          *
****************************